4 4 4 4 4 4 4 4 4 4 4 4 4 4 4 4 4 4 4 4 #
4 4 4 4 4 4 4 4 4 4 4 4 4 4 4 4 4 4 4 4 #
4 4 0 0 0 4 4 4 4 4 4 0 0 0 4 4 4 4 4 4 #
4 4 0 4 0 0 0 0 5 4 0 0 0 4 5 4 0 4 4 4 #
4 4 0 0 0 4 0 4 0 0 0 4 4 4 0 0 0 0 4 4 #
4 4 4 0 0 0 0 4 0 0 0 4 4 4 0 4 0 0 4 4 #
4 4 5 0 0 0 0 0 0 4 0 0 0 4 0 0 0 4 4 4 #
4 4 0 0 4 4 0 4 0 3 3 4 0 4 4 4 0 0 4 4 #
4 4 4 0 0 2 0 0 0 4 4 0 0 0 4 0 0 0 4 4 #
4 4 0 0 0 0 0 2 0 0 4 4 0 4 0 0 0 0 4 4 #
4 4 0 0 0 4 4 0 0 0 4 0 0 0 0 4 0 4 4 4 #
4 4 0 4 0 0 0 2 4 0 0 0 0 0 0 0 2 0 4 4 #
4 4 0 0 0 0 0 0 0 0 0 4 4 4 5 4 0 0 4 4 #
4 4 4 4 4 4 4 4 4 4 4 4 4 4 4 4 4 4 4 4 #
4 4 4 4 4 4 4 4 4 4 4 4 4 4 4 4 4 4 4 4 #
