4 4 4 4 4 4 4 4 4 4 4 4 4 4 4 4 4 4 4 4 #
4 4 4 4 4 4 4 4 4 4 4 4 4 4 4 4 4 4 4 4 #
4 4 4 4 4 4 4 4 4 4 4 4 4 4 4 4 4 4 4 4 #
4 4 4 4 4 4 4 4 4 0 0 0 0 4 4 4 4 4 4 4 #
4 4 4 4 4 4 4 4 4 5 0 4 0 4 4 4 4 4 4 4 #
4 4 4 4 4 4 4 0 2 0 0 4 2 4 4 4 4 4 4 4 #
4 4 4 4 4 4 4 0 4 0 0 4 3 4 4 4 4 4 4 4 #
4 4 4 4 4 4 4 0 4 0 5 0 0 0 4 4 4 4 4 4 #
4 4 4 4 4 4 4 0 0 0 0 4 4 0 4 4 4 4 4 4 #
4 4 4 4 4 4 4 0 0 0 0 4 4 0 4 4 4 4 4 4 #
4 4 4 4 4 4 4 4 4 4 0 4 4 0 4 4 4 4 4 4 #
4 4 4 4 4 4 4 4 4 4 0 0 0 0 4 4 4 4 4 4 #
4 4 4 4 4 4 4 4 4 4 4 4 4 4 4 4 4 4 4 4 #
4 4 4 4 4 4 4 4 4 4 4 4 4 4 4 4 4 4 4 4 #
4 4 4 4 4 4 4 4 4 4 4 4 4 4 4 4 4 4 4 4 #
