4 4 4 4 4 4 4 4 4 4 4 4 4 4 4 4 4 4 4 4 #
4 4 4 4 4 4 4 4 4 4 4 4 4 4 4 4 4 4 4 4 #
4 4 4 4 4 4 4 4 4 4 4 4 4 4 4 4 4 4 4 4 #
4 4 4 4 4 4 4 4 4 4 4 4 4 4 4 4 4 4 4 4 #
4 4 4 4 4 4 4 5 0 5 2 3 4 4 4 4 4 4 4 4 #
4 4 4 4 4 4 4 4 4 0 0 2 4 4 4 4 4 4 4 4 #
4 4 4 4 4 4 4 0 2 2 5 2 0 4 4 4 4 4 4 4 #
4 4 4 4 4 4 4 0 2 0 0 0 0 4 4 4 4 4 4 4 #
4 4 4 4 4 4 4 0 4 0 0 4 4 4 4 4 4 4 4 4 #
4 4 4 4 4 4 4 5 4 5 4 4 4 4 4 4 4 4 4 4 #
4 4 4 4 4 4 4 5 0 0 4 4 4 4 4 4 4 4 4 4 #
4 4 4 4 4 4 4 4 4 4 4 4 4 4 4 4 4 4 4 4 #
4 4 4 4 4 4 4 4 4 4 4 4 4 4 4 4 4 4 4 4 #
4 4 4 4 4 4 4 4 4 4 4 4 4 4 4 4 4 4 4 4 #
4 4 4 4 4 4 4 4 4 4 4 4 4 4 4 4 4 4 4 4 #
