4 4 4 4 4 4 4 4 4 4 4 4 4 4 4 4 4 4 4 4 #
4 4 4 4 4 4 4 4 4 4 4 4 4 4 4 4 4 4 4 4 #
4 4 0 0 0 0 0 0 0 4 4 0 4 4 0 0 0 0 4 4 #
4 4 0 0 4 0 2 4 0 0 0 0 0 0 0 0 0 3 4 4 #
4 4 0 4 4 0 0 4 0 4 4 4 0 0 0 0 4 0 4 4 #
4 4 0 0 0 0 0 0 0 0 0 0 0 4 0 0 4 4 4 4 #
4 4 4 0 4 4 4 4 4 0 4 4 4 4 0 0 0 0 4 4 #
4 4 0 0 0 0 0 0 5 5 5 5 0 0 0 4 2 4 4 4 #
4 4 4 4 0 4 0 4 4 4 0 4 0 4 0 0 4 0 4 4 #
4 4 0 0 0 0 0 0 0 4 0 4 0 0 4 0 0 0 4 4 #
4 4 0 3 2 4 0 0 0 0 0 0 0 4 0 2 0 0 4 4 #
4 4 0 0 0 0 0 4 4 0 0 0 0 0 0 0 4 0 4 4 #
4 4 0 0 0 0 0 0 4 4 0 4 4 4 4 0 4 0 4 4 #
4 4 4 4 4 4 4 4 4 4 4 4 4 4 4 4 4 4 4 4 #
4 4 4 4 4 4 4 4 4 4 4 4 4 4 4 4 4 4 4 4 #
